17,21,5
#####################
#SMMPMMMMMMMMMMMMMMS#
#M###M###M#M###M###M#
#MMMMMMMMM#MMMMMMMMM#
#M###M#M#####M#M###M#
#MMMMM#MMMMMMM#MMMMM#
#####M#M##F##M#M#####
LCMMMMMM#0G0#MMMMMMBR
#####M#M#####M#M#####
#MMMMMMMMMMMMMMMMMMM#
#M###M###M#M###M###M#
#MMM#MMMMMMMMMMM#MMM#
###M#M#M#####M#M#M###
#MMMMM#MMM#MMM#MMMMM#
#M#######M#M#######M#
#SMMMMMMMMMMMMMMMMMS#
#####################